size 18 27
geometry
0 0 0 0 0 0 0 0 0 0 0 0 0 0 0 0 0 0 0 0 0 0 0 0 0 0 0 
0 0 0 0 0 0 0 0 0 0 0 0 0 0 0 0 0 0 0 0 0 0 0 0 0 0 0 
0 0 0 0 0 0 0 0 0 0 0 0 0 0 0 0 0 0 0 0 0 2 2 2 2 0 0 
0 0 3 3 3 3 3 3 3 3 0 0 0 0 0 0 0 0 0 0 2 0 0 0 0 2 0 
0 0 3 0 0 0 0 0 0 3 0 0 0 0 0 0 0 0 0 2 0 0 0 0 0 0 2 
0 0 3 0 0 0 0 0 0 3 0 0 0 0 0 0 0 0 2 0 0 0 0 0 0 0 2 
0 0 3 0 0 6 6 0 0 3 2 2 2 2 2 2 2 2 0 0 0 0 0 0 0 0 2 
0 0 3 0 0 6 6 0 0 0 0 0 0 0 0 0 0 0 0 0 0 0 0 0 0 0 2 
0 0 3 0 0 0 0 0 0 3 2 0 2 2 2 2 2 2 0 0 0 0 0 0 0 0 2 
0 0 3 0 0 0 0 0 3 0 2 0 2 0 0 0 0 0 2 0 0 0 0 0 0 0 2 
0 0 3 0 0 0 0 0 3 0 2 0 2 0 0 0 0 0 0 2 0 0 0 0 0 0 2 
0 0 3 3 3 3 3 3 3 0 1 0 1 0 0 0 0 0 0 0 2 0 0 0 0 2 0 
0 0 0 0 0 0 0 0 0 1 0 0 0 1 0 0 0 0 0 0 0 2 2 2 2 0 0 
0 0 0 0 0 0 0 0 0 1 0 0 0 1 0 0 0 0 0 0 0 0 0 0 0 0 0 
0 0 0 0 0 0 0 0 0 1 0 0 0 1 0 0 0 0 0 0 0 0 0 0 0 0 0 
0 0 0 0 0 0 0 0 0 1 0 0 0 1 0 0 0 0 0 0 0 0 0 0 0 0 0 
0 0 0 0 0 0 0 0 0 1 0 0 0 1 0 0 0 0 0 0 0 0 0 0 0 0 0 
0 0 0 0 0 0 0 0 0 0 1 1 1 0 0 0 0 0 0 0 0 0 0 0 0 0 0 
floors
0 0 0 0 0 0 0 0 0 0 0 0 0 0 0 0 0 0 0 0 0 0 0 0 0 0 0 
0 0 0 0 0 0 0 0 0 0 0 0 0 0 0 0 0 0 0 0 0 0 0 0 0 0 0 
0 0 0 0 0 0 0 0 0 0 0 0 0 0 0 0 0 0 0 0 0 0 0 0 0 0 0 
0 0 0 0 0 0 0 0 0 0 0 0 0 0 0 0 0 0 0 0 0 1 1 1 1 0 0 
0 0 0 5 5 5 5 5 5 0 0 0 0 0 0 0 0 0 0 0 1 1 1 1 1 1 0 
0 0 0 5 5 5 5 5 5 0 0 0 0 0 0 0 0 0 0 1 1 1 1 1 1 1 0 
0 0 0 5 5 0 0 5 5 0 0 0 0 0 0 0 0 0 1 1 1 1 1 1 1 1 0 
0 0 0 5 5 0 0 5 5 3 3 3 3 3 3 3 3 3 1 1 1 1 1 1 1 1 0 
0 0 0 5 5 5 5 5 5 0 0 3 0 0 0 0 0 0 1 1 1 1 1 1 1 1 0 
0 0 0 5 5 5 5 5 0 0 0 3 0 0 0 0 0 0 0 1 1 1 1 1 1 1 0 
0 0 0 5 5 5 5 5 0 0 0 3 0 0 0 0 0 0 0 0 1 1 1 1 1 1 0 
0 0 0 0 0 0 0 0 0 0 0 3 0 0 0 0 0 0 0 0 0 1 1 1 1 0 0 
0 0 0 0 0 0 0 0 0 0 1 1 1 0 0 0 0 0 0 0 0 0 0 0 0 0 0 
0 0 0 0 0 0 0 0 0 0 1 1 1 0 0 0 0 0 0 0 0 0 0 0 0 0 0 
0 0 0 0 0 0 0 0 0 0 1 1 1 0 0 0 0 0 0 0 0 0 0 0 0 0 0 
0 0 0 0 0 0 0 0 0 0 1 1 1 0 0 0 0 0 0 0 0 0 0 0 0 0 0 
0 0 0 0 0 0 0 0 0 0 1 1 1 0 0 0 0 0 0 0 0 0 0 0 0 0 0 
0 0 0 0 0 0 0 0 0 0 0 0 0 0 0 0 0 0 0 0 0 0 0 0 0 0 0 
ceilings
0 0 0 0 0 0 0 0 0 0 0 0 0 0 0 0 0 0 0 0 0 0 0 0 0 0 0 
0 0 0 0 0 0 0 0 0 0 0 0 0 0 0 0 0 0 0 0 0 0 0 0 0 0 0 
0 0 0 0 0 0 0 0 0 0 0 0 0 0 0 0 0 0 0 0 0 0 0 0 0 0 0 
0 0 0 0 0 0 0 0 0 0 0 0 0 0 0 0 0 0 0 0 0 2 2 2 2 0 0 
0 0 0 6 6 6 6 6 6 0 0 0 0 0 0 0 0 0 0 0 2 2 2 2 2 2 0 
0 0 0 6 6 6 6 6 6 0 0 0 0 0 0 0 0 0 0 2 2 2 2 2 2 2 0 
0 0 0 6 6 0 0 6 6 0 0 0 0 0 0 0 0 0 2 2 2 2 2 2 2 2 0 
0 0 0 6 6 0 0 6 6 4 4 4 4 4 4 4 4 4 2 2 2 2 2 2 2 2 0 
0 0 0 6 6 6 6 6 6 0 0 4 0 0 0 0 0 0 2 2 2 2 2 2 2 2 0 
0 0 0 6 6 6 6 6 0 0 0 4 0 0 0 0 0 0 0 2 2 2 2 2 2 2 0 
0 0 0 6 6 6 6 6 0 0 0 4 0 0 0 0 0 0 0 0 2 2 2 2 2 2 0 
0 0 0 0 0 0 0 0 0 0 0 4 0 0 0 0 0 0 0 0 0 2 2 2 2 0 0 
0 0 0 0 0 0 0 0 0 0 2 2 2 0 0 0 0 0 0 0 0 0 0 0 0 0 0 
0 0 0 0 0 0 0 0 0 0 2 2 2 0 0 0 0 0 0 0 0 0 0 0 0 0 0 
0 0 0 0 0 0 0 0 0 0 2 2 2 0 0 0 0 0 0 0 0 0 0 0 0 0 0 
0 0 0 0 0 0 0 0 0 0 2 2 2 0 0 0 0 0 0 0 0 0 0 0 0 0 0 
0 0 0 0 0 0 0 0 0 0 2 2 2 0 0 0 0 0 0 0 0 0 0 0 0 0 0 
0 0 0 0 0 0 0 0 0 0 0 0 0 0 0 0 0 0 0 0 0 0 0 0 0 0 0 
things
player 11 15